XXXXXXXXXXXXXXXXXXXXXXXXXXXXXXXXXXXXXXXXXXXXX
X3212321211112321111212212132132121121212221X
X222222211XXXXXXXXX21112211XXXXXXXX2e2111211X
X12322321XXXXXXXXXXXX33121XXXXXXXXXXX1111111X
X1111111XXXXXXXXXXXXXX111XXXXXXXXXXXXX112111X
X121111XXXXXXXXXXXXXXXX1XXXXXXXXXXXXXXX12111X
X1X112X1XXXXXXXXXXXXXXXXXXXXXXXXXXXXXX112111X
XXX21XX111XXXXXXXXXXXXXXXXXXXXXXXXXX11112111X
X2X212111112XXXXXXXXXXXXXXXXXXXXXXX111112111X
X222111X121211XXXXXXXXXXXXXXXXXXX11111112111X
X113112X13221223XXXXXXXXXXXXXXX11X1111112111X
XXX21XX11112111111XXXXXXXXXXX1111X1111112111X
X2X2121XX1X21111111XXXXXXXXX11111X1111112111X
X222111X121X1122122c2XXXXXX111111X1111a12111X
X11211211d2X1223132331XXX233331111X111111211X
XXXXXXXXXXXXXXXXXXXXXXXXXXXXXXXXXXXXXXXXXXXXX